

  NO ./textures/north.xpm
      SO ./textures/south.xpm
WE ./textures/east.xpm
EA ./textures/west.xpm


F 255,255,255
C 0,0,0



11111   1
100101
102001

1100N1

111111

