

NO ./textures/north.xpm
SO ./textures/south.xpm
WE ./textures/west.xpm
EA ./textures/east.xpm

F 153, 153,       255
C 153,204,255

111111
100101
101001
1100N1
111111

