
NO ./textures/north.xpm
SO ./textures/south.xpm
WE ./textures/east.xpm
EA ./textures/west.xpm


F 189,195,199
C 236,240,241

        1111111111111111111111111
        1000000000110000000000001
        1011000000110000000000001
        100100000000000000000001
111111111011000000110000000000001
100000000011000001112111111111111
11110111111111011100000010001
11110111111111011101010010001
11000000110101011100000010001
10000000000000001100000020001
10000000000000001101010010001
110000011101010111011110W0001
11110111 1110101 101111010001
11111111 1111111 111111111111

111
101
111