



NO ./textures/north.xpm
SO ./textures/south.xpm
WE ./textures/east.xpm
EA ./textures/west.xpm


F 0,255,0
C 225,30,0

111111111111111111111111111111111
100000001000000000110000000000001
100000001011000001110000001000001
100000001001000000000000000000001
111111111011000001110000000000001
100000000011000001110111111111111
11110111111111011100000010001
11110111111111011101010010001
11000000110101011100000010001
10001000000000001100000010001
10000000000000001101010010001
11000001110101011111011110N01
11110111 1110101 101111010001
11111111 1111111 111111111111