NO ./textures/north.xpm
SO ./textures/south.xpm
WE ./textures/east.xpm
EA ./textures/west.xpm

F 189,195,199
C 236,240,241
                      
                            1111111111111
     111111                 1000000000001
     100001      1111111111110000000000011111
     1000011     1000000000010000000000010001
     1000001     1000000000000000000000000101
     1000001     1000000000010000000000010001
     11101111111 1000111111110000000000011111
     10000000001 10001      1000000000001
     1000000000111000111    1111110111111
     1000000000100000001        10001
     1000000000000000011        10001
     1000000000100000001        10001
111111000000000111111111        10001
1000110000000001                10001
1000111111011111           1111 1000111
10001   10001              100110000001
11011   10001              1001 1000111
1000111110001              1001 10001
1000100010001              1001 10001
1000000010001              1111100011
1000100010001                   10001
1000111111011111                11011                1111111111
1000110000000001          11111100000111111          1000000001
1000110000000001          10000000000000001          1000000001
1000110000000001          100000000000000111111111111000000001
1000010000000001          1000000000000000010000000001000000001
1000000000000001          1000000000000000000000000000000000001
1000010000000001          1000000000000000010000000001000000001
1000110000000001          1000000000000000111100001111000000001
1000110000000001          10000000000000001   1001   1000000001
1000110000000001          11111100000111111   1001   1000000001
1000111111011111                11011         1001    110110111
10001   10001                   10001         1001    1111111
1000111110001                   10001         1001
1000100010001                   10001         1001 111111111
1000000010001                   10001         1001 1010101011
1000100010001                   10001         100010000000001
1000111110001                   10001         100000000000001
1000111110001111111111111       10001         100010000000001
100000000000000001000000111     10001          11111010101011
100000000000000000000000101     10001              111111111
100000000000000001000001111     10001
111111111111111111111111        10001
         111001001001      111111101111111
         101001001011      100001000100001
         11100000111       100000000000001
           1101111         100001000100001
            1001           100001000100001
            1001           111111000111111
            1111           100001000100001
                           10N000000000001
                           100001000100001
                           111111000111111
                           100000000000001
                           100000000000001
                           100000000000001
                           111111111111111