
NO ./textures/north.xpm
SO ./textures/south.xpm
WE ./textures/east.xpm
EA ./textures/west.xpm
F 220,100,0
C 225,30,0
111 11
100001
101001
1100N1
111111