

NO ./textures/north.xpm
SO ./textures/south.xpm
WE ./textures/east.xpm
EA ./textures/west.xpm


F 220,110,0
C 225,30,0



11111   1
200101
102001

1100N1

111111

