
NO ./textures/north.xpm
SO ./textures/south.xpm
WE ./textures/east.xpm
EA ./textures/west.xpm
F 220,100,0
C 225,30,0

111111
100101
10t001

1100N1
111111