

NO ./textures/north.xpm
SO ./textures/south.xpm
WE ./textures/east.xpm
EA ./textures/west.xpm
F 110, 24, 0
C 9, 7, 2557
111111
100101
101001
1100N1
111111